R 1400 900


SO ./textures/so.xpm
WE ./textures/we.xpm
NO ./textures/no.xpm
EA ./textures/ea.xpm

S ./textures/5.xpm
F 255,122,0
C 50, 0, 255

        111111111111111111111111111111111111111111111111111111111111111
        100000000011000000000000100000000000010000000100000002000000001
        101100000111000000200000100000000000001000001000000000000000001
        100100000000000000000000100000000000000100010000000000000000001
11111111101100000111000000000000100000000000000210100000000000000000001
10000000001100000111011111111111100000000000000001000000000000000000001
1111011111111101110000001000100000000000000000000000000000000000000000111
 111011111111101110101001000100000000000000000000000000000000000000000001
1100000011010101110000000000100022000000000000000000000000000000000000111
1E002000000000001100000010001000000000000000000000000000000000000000001
10000000000000001101010010001000000000000000000000000000000000000000001
11000001110101011111011110001000000000000000000000000000000000000000001
11110111 1110101 101111010000000000000000000000000000000000000000000001
11111111 1111111 111111111111111111111111111111111111111111111111111111