R 1001 701


SO ./textures/so.xpm
WE ./textures/we.xpm
NO ./textures/no.xpm
EA ./textures/ea.xpm


S ./textures/5.xpm
F 92,92,92
C 148, 227, 224

        111111111111111111111111111111111111111111111111111111111111111
        100000000011000000000000100000000000010000000100000002000000001
        101100000111000000200000100000000000001000001000000000000000001
        100100000000000000000000100000000000000100010000000000000000001
11111111101100000111000000000000100000000000000210100000000000000000001
10000000001100000111011111111111100000000000000001000000000000000000001
1111011111111101110000001000100000000000000000000000000000000000000000111
 111011111111101110101001000100000000000000000000000000000000000000000001
11000000110101011100000000001000220000000S0000000000000000000000000000111
10002000000000001100000010001000000000000000000000000000000000000000001
10000000000000001101010010001000000000000000000000000000000000000000001
11000001110101011111011110001000000000000000000000000000000000000000001
11110111 1110101 101111010000000000000000000000000000000000000000000001
11111111 1111111 111111111111111111111111111111111111111111111111111111